NO ./textures/north.xpm
EA ./textures/east.xpm
SO ./textures/south.xpm
WE ./textures/west.xpm

C 135,206,235
F 102,93,74

1111111
1000001
1000001
100N001
1000001
1000001
1111111
