NO ./textures/north.xpm
EA ./textures/east.xpm
SO ./textures/south.xpm
WE ./textures/west.xpm

C 135,206,235
F 102,93,74

1111111111111
1000000000001
1000000111001
100E000001001
1000000111001
1000000000001
1111111111111
