SO textures/south.xpm
F 167,200,12
WE textures/west.xpm
EA textures/east.xpm



C 89,222,030

11111
10001
10N01
10001
11111
