NO textures/north.xpm
EA textures/east.xpm


SO textures/south.xpm

WE textures/west.xpm

C 127,127,127
F 0,127,0

11111111111111
10000000000001
10000000000001
10000000000001
1000000000000011111111111111
1000E00000000000001000000001
1000000000000000001000000001
1111111111011110001000000001
         101  10001000000001
         101  10001000000001
      11110111100000000W0001
      1000000010001000000001
      1000000010001111111111
      1000N00000001
      1000000010001
      1111111110001
              10001
              10001
              11111
