NO ./textures/north.xpm
EA ./textures/east.xpm
SO ./textures/south.xpm
WE ./textures/west.xpm

C 135,206,235
F 102,93,74

11111111
10000001
10000001
100E0000
10000001
10000001
11111111
